NO ./assets/wall11.xpm
SO ./assets/wall2.xpm
ES ./assets/test2.xpm
WE ./assets/wall4.xpm

F 180,255,94
C 94,128,241


1111111111
1000000001
1000000001
10000W0001
1000000001
1000000001
1000000001
1111111111