NO ./assets/wall2.xpm
SO ./assets/wall2.xpm
ES ./assets/wall3.xpm
WE ./assets/wall4.xpm

F 180,255,94
C 94,128,241

1111111
10NSJ0001
100EW001
11111111
